在雨天临时停车时  -->开启危险报警闪光灯 
会车中遇到对方来车行进有困难需借道时  -->对方先行礼让 
行车中  发现时，应减速停车，依次排队等候  --> x
在道路上  故障发生机动车  -->需要停车排除时， 不妨碍交通的地方 驾驶人停车 
行车中遇儿童时  -->减速 必要时 停车 
驾驶车辆驶入铁路道口前减速降挡  -->进入道口后 挡位 
行经市区交通流量大的路段时  -->不得超车 
在高速公路遇到能见度低于50米的气象条件时  -->车速不得超过20公里/小时 尽快驶离高速公路 
夜间车辆通过照明条件良好的路段时  -->使用近光灯 
行车中遇列队横过道路的学生时  -->停车 
驶近停在车站的公交车辆  -->预防公交车突然起步或行人从车前穿出，应减速，保持足够间距，随时准备停车 
车辆驶近人行横道时  -->先减速 注意观察行人、非机动车动态 确认安全后 再通过 
在路边停车时  -->停放在停车泊位内 
驾驶车辆在交叉路口前变更车道时  在虚线区  -->按导向箭头指示 x
当驾驶车辆行经两侧有行人且有积水的路面时  -->减速 
在堵车的交叉路口绿灯亮时  -->车辆不能驶入交叉路口 
车辆临时靠边停车后准备起步时  -->先观察周围交通情况 
冰雪路行车时  -->注意制动距离延长 
夜间驾驶车辆遇自行车对向驶来时  -->使用近光灯 
遇有前方交叉路口交通阻塞时  在路口外  -->依次停 x
行车中  -->抢救伤员的救护车遇 从本车道逆向驶来时， 减速 x
车辆通过凹凸路面  -->通过凹凸路面时， 低速缓慢平稳通过 x
行车中遇有非机动车准备绕过停放的车辆时  -->其让先行 
驾驶的车辆正在被其他车辆超越时  -->减速 靠右侧行驶 
在山区道路遇对向来车时  -->减速 
行经人行横道时  -->不得超车 
机动车在道路边临时停车时  -->逆向 
在雪天临时停车时  -->开启危险报警闪光灯 
在窄桥、弯道时  -->不得超车 
车辆在山区道路跟车行驶时  -->适当加大安全距离 
驾驶人行车中看到注意儿童标志的时候  -->谨慎选择行车速度 
通过没有交通信号的交叉路口  -->减速 
在泥泞道路行驶时  -->最高速度不能超过30公里/小时 
雾天行车时  -->及时开启雾灯 
驾驶车辆进入高速公路加速车道后  -->尽快提高车速 
车辆涉水后  -->保持低速行驶 
在道路上向左变更车道时  -->开启左转向灯 
在没有中心线的道路上  发现  如果条件许可  -->发现后车发出超车信号 靠右降速让路 x
驾驶人在行车中  -->经过积水路面时， 减速 x
在冰雪道路行驶时  -->最高速度不能超过30公里/小时 
通过急弯路时  -->最高速度不能超过30公里/小时 
通过铁路道口时  -->最高速度不能超过30公里/小时 
在  暴雨天气驾车  -->刮水器无法刮净雨水时， 立即减速 x
在进出非机动车道时  -->最高速度不能超过30公里/小时 
前轮胎爆裂已出现转向时  -->驾驶人不要 过度矫正 在控制住方向的情况下， 制动踏板 
在没有道路中心线的狭窄山路  -->不靠山体的先行 
在涉水路段跟车行驶时  -->适当增加车距 
牵引发生故障的机动车时  -->最高车速不得超过30公里/小时 
夜间  -->行车 可选择路宽车少时， 超车 x
同车道行驶的车辆前方遇到执行任务的消防车时  -->不得超车 
在没有中心隔离设施或者没有中心线的道路上  -->行驶 x
机动车  -->变更注意不能影响其他车辆正常行驶 
行至漫水路时  -->低速通过涉水路段 
下陡坡、转弯、掉头时  -->最高速度不能超过30公里/小时 
在高速公路遇到能见度低于200米的气象条件时  -->最高车速不得超过60公里/小时 
夜间  在窄路、窄桥会车  -->开启近光灯
通过窄路、窄桥  -->最高速度不能超过30公里/小时 
在山区道路  -->超车 选择宽阔的缓上坡路段 
驶入高速公路的收费口时  -->绿灯选择亮 
经交叉路口时  -->不得超车 
下长坡时  -->控制车速 发动机除了刹车制动以外还有制动 
行车中遇到后方车辆要求超车时  -->及时减速 后 靠右行驶 
在道路上靠路边停车过程中  -->开启右转向灯 
驶入双向行驶隧道前  -->开启示廓灯或近光灯 
车辆行驶  -->当驾驶车辆行经两侧有非机动车行驶且有积水的路面时， 减速 
行驶车道绿灯亮时  -->但车辆前方人行横道仍有行走 通过后 再起步 
在高速公路遇到能见度低于100米的气象条件时  -->最高车速不得超过40公里/小时 
遇雾、雨、雪等能见度在  -->在50米以内时， 最高速度不能超过30公里/小时 
遇到前方车辆停车排队等候或缓慢行驶时  -->依次行驶 
在没有中心线的道路上遇相对方向来车时  -->减速 靠右行驶 
同车道行驶的车辆前方遇到执行任务的救护车时  -->不得超车 
同车道行驶的车辆前方遇到执行任务的警车时  -->不得超车 
在狭窄的路段会车时  -->做到礼让三先：先慢、先让、先停 
行车中遇到执行紧急任务的消防车、救护车、工程救险车时  -->要 及时让行 
在高速公路  -->要 按照限速标志标明的车速行驶 
在道路上  临时停车  -->妨碍其他车辆和行人通行 
驾驶车辆在道路上行驶时  -->按照安全行驶 
机动车在夜间道路上发生故障难以移动时  -->开启危险报警闪光灯、示廓灯、后位灯 
距离宽度不足4米的窄路50米以内的路段  -->不能停车 
桥梁、陡坡、隧道50米以内的路段距离  -->不能停车 
行车中遇到正在进行作业的道路养护车辆、工程作业车时  -->要 注意避让 
通过经常发生塌方、泥石流的山区地段  -->避免停车 
驾驶车辆通过人行横道线  -->通过人行横道线时， 注意礼让行人 
进入红色叉形灯或者红色箭头灯亮的车道  --> x
车辆驶离高速公路  -->经减速车道减速后进入匝道 
通过隧道时  -->不得超车 
车辆在山区道路行车下陡坡时  -->不得超车 
车辆长  -->间停放时， 选择停车场 x
通过窄路、窄桥时，的最高速度  -->不能超过每小时30公里 
在高速公路匝道上  -->车辆不得倒车 
在冰雪路面上行车降低车速  -->加大安全距离 
变更车道前  -->仔细观察 目的是判断有无变更车道的条件 
在划有道路中心线的道路上会车时  -->做到保持安全车速、不越线行驶 
在没有交通信号指示的交叉路口  -->转弯的机动车让直行的车辆和行人先行 
遇到沙尘、冰雹、雨、雾、结冰等气象条件时  -->降低行驶速度 
其他车辆不准进入专用车道行驶  -->其目的是为了不影响专用车的正常通行 
在隧道、陡坡等特殊路段  -->超车 x
在  -->开启雾灯和危险报警闪光灯 x
遇后车超车  -->遇后车超车时，在条件许可的情况下应减速靠右让路，是为了给后车留出超车空间 x
专用车道规定的专用使用时  间之外  -->其他车辆进入 可以行驶 
在通过山区道路弯道时  -->要 做到“减速、鸣喇叭、靠右行” 
交通信号灯  组成由红灯、绿灯和黄灯  --> x
发生故障或事故不能正常行驶时  -->立即打开危险报警闪光灯
下长坡时  -->靠行车制动器仅制动 容易引起行车制动器失灵 
在高速公路上  -->行驶 能见度小于200米时， 车速不得超过每小时60公里 x
在高速公路上  -->行驶 能见度小于200米时， 与同车车道前车保持100米以上的距离 x
在道路上掉头时  -->开启左转向灯 
在交叉路口、隧道内  -->不能倒车 
在高速公路匝道上  -->车辆不得掉头 
机动车在高速公路上遇前方交通受阻时  跟随前车顺序  -->排队 立即开启危险报警闪光灯 防止追尾 
夜间起步前  -->先开启近光灯 
行车中遇残疾人影响通行时  -->主动减速 
行车中  发现行人突然横过道路时  -->迅速减速 
在没有交通信号的路口遇到前方车辆缓慢行驶时  -->依次交替 
通过铁路道口时  -->不得超车 
通过窄路、窄桥时  -->不得超车 
行车中从其他道路汇入车流前  -->注意后方车辆的动态 
在道路上掉头时  -->开启左转向灯 
驾驶人发现轮胎漏气  -->不要将车辆驶离主车道时， 不要采用紧急制动 以免造成翻车或后车采取制动不及时导致追尾事故 
车辆行至泥泞或翻浆路段时  -->停车 选择平整、坚实的路段缓慢 缓慢通过 
通过交叉路口  -->遵守交通信号 
夜间通过人行横道时  -->交替使用远近光灯 
小型客车行驶在平坦的高速公路上  -->突然有颠簸感觉时， 迅速降低车速 防止爆胎 x
遇到漫水桥时  -->要 确认安全后 低速通过 
上路前  -->检查车辆安全技术性能 
夜间机动车通过照明条件良好的路段时  -->要近光灯 
机动车驶入双向行驶隧道前  -->开启近光灯 
在山区道路  -->加大安全距离 
山区上坡路段跟车过程中遇前车停车时  -->保持大距离停车 
下长坡  -->车速最安全的方法控制 是利用发动机制动 
在高速公路行车时  -->降低车速 
机动车停车的错误做法是  停放在非机动车道上  --> x
遇到沙尘、冰雹、雾、雨、雪等低能见度条件时  -->开启前照灯、示廓灯和后位灯 
夜间超车遇前车不让路时  -->保持距离 
机动车在高速公路上发生故障需检查时  在应急车道  -->停车 x
在雪天临时停车时  -->开启危险报警闪光灯、示廓灯和后位灯 
机动车在雾天行驶时  -->雾灯和危险开启报警闪光灯 
在  -->注意制动距离延长 x
遇到大雾或特大雾等能见度过低天气时  -->选择安全地点 x
超车时  发现前方机动车正在超车  -->驾驶人，停止超车 前方机动车让先超车 
超车过程中  被超车辆突然加速  -->放弃超车 
高速公路行车紧急情况避险的处理原则  -->是先避人后避物 
夜间驾驶汽车通过十字交叉路口交替使用远近光灯的目的  是使其他交通参与者更容易发现自己  --> x
在冰雪路面  -->保持较大的安全距离 
雨天安全行车的注意事项  -->是避免紧急制动、紧急转向，保持足够的安全距离，注意非机动车和行人动态，选择安全车速行驶 
夜间行车中汽车发生故障需要停车时  -->尽量选择安全区域停车 开启危险报警闪光灯 开启示廓灯和后位灯 按规定设置警告标志 
在进出隧道时  -->注意提前降低车速 
雨天机动车在高速公路行驶发生“水滑”现象时  -->踏板减速 
驾驶汽车进入双向通行的隧道时  注意对向来车  -->注意开启近光灯 靠右侧行驶 
拥堵的环形路口  -->避让注意已在路口内车辆 
在  -->同行车向3车道高速公路上 在最左侧车道上 车速高于每小时90公里、低于每小时110公里的机动车不行驶 x
机动车在冰雪路面样的路面上制动时  -->车轮最容易 x
行经驼峰桥会车时  -->降低车速 靠右通行 鸣喇叭示意 
在夜间发生故障时  -->选择安全区域停车 开启危险报警闪光灯、示廓灯和后位灯 按规定设置警告标志 
驾驶汽车在山区道路下陡坡时  -->挂 低速挡 
夜间遇到  提示对向来车未关闭远光灯时，  --> x
在匝道内  -->行驶 依次通行 
在高速公路减速车道行驶时  -->依次通行 
在高速公路匝道路段  -->行驶 驶离高速公路进入匝道时， 开启右转向灯 x
遇到前方车辆停车  -->等待行人通过人行横道时， 与前车保持安全距离 x
行经两侧有  -->非机动车行驶 行驶且有积水的路面时， 减速 x
在山区道路行驶时  -->驾驶人要 注意保持与前车的安全距离 避免时占道行驶，上陡坡提前换低速挡，下长坡时，充分利用发动机制动 
检查机动车机油时  在平坦的地方  -->停 在启动前 检查 x
过程中遇到专注于使用手机的行人时  -->注意观察 做好停车准备 
在高速公路上  -->行驶 遇有能见度小于100米的气象条件时， 与前车保持50米以上的距离 车速不得超过40公里/小时 开启危险报警闪光灯 x
夜间  在农村道路  -->行驶 遇到对向驶来畜力车时， 使用近光灯 靠右避让 x
如果轮胎胎侧顺线出现裂口  -->及时换胎 
在山区路段超车时  -->开启左转向灯 确认前车让超后超越 
选择停车场  -->道路施划的停车泊位内地点停车 
轮胎气压过低时  -->高速行驶导致爆胎结果 
隧道前50米米内  -->距离 x
发动机着火后  -->迅速关闭发动机 
在泥泞路段遇驱动车轮空转打滑时  在驱动轮下  -->铺垫砂石 x
在泥泞路段  -->行车容易出现侧滑现象 
在雨天临时停车时  -->开启危险报警闪光灯 
出车前检查的目的  -->是确认机动车车胎是否损毁，确认周围是否有障碍物，确认在车辆附近是否存在安全隐患，确认出车方向的安全性 
在泥泞路段遇车后轮向右侧滑时  -->转向向右
下坡路行车中  制动突然失效  -->利用避险车道 
机动车在高速公路  -->非紧急情况时， 在应急车道 不得行驶 
在山区冰雪道路上  -->遇前车正在爬坡 前车通过后 再爬坡 
驶入高速公路匝道后  -->不准 x
行车中发动机突然熄火  -->缓慢减速 
发生紧急故障必须停车检查时  在应急车道  -->停车 x
行车中与其他机动车发生正面碰撞已不可避免时  -->迅速采取紧急制动 
在照明条件良好的路段  -->行驶跟车 使用近光灯 x
会车中道路一侧有障碍  -->双方机动车应有障碍的一方让对向先行 
驾驶人进入驾驶室前  -->首先要 做机动车周围情况 x
机动车驶入高速公路  -->开启左转向灯 
后轮胎爆裂时  -->驾驶人要 控制行驶方向 慢慢减速 
驾驶装有动力转向的机动车发现转向困难  -->查明原因 
在雨天  -->撑雨伞和穿雨衣的行人遇到 在路边 行走 x
行车中轮胎突然爆裂时，的应急措施是  -->平稳停车 
机动车驶出高速公路隧道口时  -->明显出现方向偏移情况 
行车中  遇到转向失控  -->行驶方向偏离时， 尽快减速 
避免爆胎的错误做法  -->是降低轮胎气压 
下长坡  -->控制车速的正确方法是挂低速挡 
在狭窄的坡路会车时  -->让上坡车 
机动车在夜间  -->行驶 降低速度 谨慎驾驶 
机动车驶离高速公路时  -->开启右转向灯 
进入高速公路加速车道后  -->尽快提高车速 
前轮爆胎  -->驾驶人控制住行驶方向后， 采取抢挂低速挡措施 
驾驶汽车遇雨、雪、雾等视线不清或路面较滑时  -->降低车速行驶 加大横向间距 必要时 停车 
在高速公路上遇到紧急情况避险时  -->注意 制动措施采取减速 
在道路上  -->注意观察前车动态 随时做好减速准备 保持安全距离 
在高速公路行车道上紧急停车时  -->迅速转移 x
机动车在夜间临时停车时  -->开启危险报警闪光灯、示廓灯和后位灯 
在高速公路意外碰撞护栏时  -->采取 适量修正保护措施 
停车观察水情确认安全后  -->挂 挡匀速通过 x
夜间  在窄路或者窄桥遇自行车对向驶来时  -->使用近光灯 
选择停车场  -->道路施划的停车泊位内地点停车 
在高速公路  -->行驶 雨天发生“水滑”现象时， 双手 握转向盘 逐渐降低车速 x
驶出小区上  -->在不妨碍主路车辆正常行驶的前提下 汇车流 x
车辆发生“水滑”时  逐渐加速踏板  -->不可踩制动踏板 车速让逐渐减缓 迅速转向 x
高速公路上  -->行车 向前行驶 x
在结冰的道路上  -->减速 缓慢交会 x
在雾天  -->保持大间距 
遇到校车在道路右侧停车上下学生时  注意同向只有一条机动车道，后方机动车应当停车等待，同向有三条机动车道，中间车道后方机动车应当停车等待，同向有三条机动车道，左侧车道后方机动车可以减速通过  -->x
在雾天临时停车时  -->开启危险报警闪光灯、示廓灯和后位灯 
在注意与前车保持安全距离的同时  -->也要 谨慎制动 被后车追尾防止 
机动车在路边起步后  -->随时注意机动车两侧道路情况 缓慢转向 逐渐驶入正常行驶道路 
出车前检查冷却液、发动机机油、燃油等  -->是否有渗漏现象 
扑救易散发腐蚀性蒸气或有毒气体的火灾时  -->扑救人员穿戴 站在上风处 
在泥泞路行车中发生侧滑时  -->适量修正向后轮侧滑的方向 
在雨天起步前  -->要 使用刮水器 
夜间通过拱桥时  -->交替使用远近光灯 
在山区冰雪道路上  -->行驶 遇到前车正在爬坡时， 后车选择适当地点停车，等前车通过后再爬坡 
在高速公路减速车道行驶时  -->要 依次通行 
正在超车的车辆  -->不得超越 
同方向有三条机动车道的路段  车道后方和相邻机动车道上的机动车停靠  -->在右侧车道停靠上、下学生时， x
行驶过程中  -->驾驶人要 随时注意与前车的安全距离 随着车速的提高增加安全距离 
夜间起步  -->首先开启近光灯 
通过桥梁时  -->一般要 x
驶出隧道时  -->注意明暗视力的变化 控制车速 
在高速公路行驶遇到横风时  -->握方向盘 x
遇浓雾或沙尘暴时  -->打开雾灯或者危险报警闪光灯 
驾驶客车遇非常情况或者发生事故时  -->将降 因紧急避险决不能造成二次事故或更大的损失 x
在高速公路上遇到紧急情况时  -->转向避让 x
在坡道路段跟车行驶时  -->保留比平路跟车时更大的安全距离 
遇到同车道行驶的执行紧急任务的特种车辆时  -->不得超车 
在高速公路上遇到紧急情况时  -->转向避让 
在高速公路  如果转向失灵发生  -->行驶 紧急制动 x
在冰雪道路上行车时  -->降低机动车的稳定性 急时 空转车轮 x
机动车  -->经交叉路口不得超车 x
遇到成群青少年绕过路边停放的机动车时  -->要 主动减速 
在隧道中  -->机动车不得倒车 
驾驶人发现轮胎漏气  -->不要将机动车驶离主车道时， 不要采用紧急制动 以免造成翻车或后车采取制动不及时导致追尾事故 
在高速公路上  -->不要频繁地变更车道 
驶离高速公路  -->经过减速车道减速后进入匝道 
通过连续弯道时  靠弯道右侧尽量行驶  --> x
在道路上停车时  -->尽量避开坡道、积水、结冰或松软路面 
在高速公路匝道上  -->不准停车 
出现制动失效后  -->首先控制方向 再设法 控制车速 
机动车驶离高速公路进入匝道后  -->车速使降到限定时 速以下 
在高速公路上  除遇障碍、发生故障等必须停车外，不准  -->除 停车上下人员或者装卸货物 x
行车中发动机突然熄火后不能启动时  -->及时停车 检查熄火原因 
机动车行至泥泞或翻浆路段时  -->要 缓慢通过选择平整、坚实或有车辙的路段 
车辆在路边起步后  -->随时注意车辆两侧道路情况 缓慢转向 逐渐驶入正常行驶的车道 

257-58 = 199