驶近没有人行横道的交叉路口时 发现有人横穿道路 -->应减速或停车让行 
驾驶人在超车时 前方车辆不减速、不让道 -->应停止继续超车 
会车前选择的交会位置不理想时 -->应减速、低速会车或停车让行 
发现前方道路堵塞 -->按顺序停车等候 
在标志、标线齐全的高速公路上行车 -->应当按照标志或标线 
行车中超越同向行驶的自行车时 减速慢行 -->应注意观察动态 留有足够的安全距离 
-->驾驶小型载客汽车在高速公路上时速低于100公里时的最小跟车距离是不得少于50米 x
上道路行驶 -->不允许超过限速标志标明的最高时速。 
车辆在拥挤路段低速行驶时 遇其他车辆强行插队 -->应主动礼让 确保行车安全 
行车中遇到对向来车占道行驶 -->应主动给对方让行 
夜间驾驶车辆遇自行车对向驶来时 -->应使用近光灯 减速或停车避让 
在车道减少的路口 遇到前方车辆依次停车或缓慢行驶时 -->每车道一辆依次交替驶入路口 
车辆行至交叉路口 遇有转弯的车辆抢行 -->应停车避让 
行车中遇抢救伤员的救护车从本车道逆向驶来时 -->应靠边减速或停车让行 
-->驾驶小型载客汽车在高速公路上时速超过100公里时的跟车距离是保持100米以上 x
驾驶车辆通过无人看守的铁路道口时 -->应一停、二看、三通过 
遇有浓雾或特大雾天能见度过低 行车困难时 -->应开启危险报警闪光灯和雾灯 选择安全地点停车 
机动车在道路边临时停车时 -->应不得逆向或并列停放 
在夜间超车时 -->变换远、近光灯 
但对向来车已接近障碍物时 -->应降低速度或停车 行车中需要借道绕过前方障碍物 让对向来车优先通行 
进入左侧道路超车 无法保证与正常行驶前车的横向安全间距时 -->应放弃超车 
车辆在较窄的山路上行驶时 如果靠山体的一方不让行 -->应提前减速或停车避让 
在路口右转弯遇同车道前车等候放行信号时 -->依次停车等候 
在山区冰雪道路上行车 遇有前车正在爬坡时 后车 -->应选择适当地点停车 等前车通过后再爬坡 
-->变更车道为提示其他车辆我方准备变更车道 x
机动车向左转弯、向左变更车道 驶离停车地点及掉头时 -->提前开启左转向灯是为了提示后车 将要向左变更行驶路线 
遇前方路段车道减少 车辆行驶缓慢 为保证安全有序 -->应该依次交替通行 
夜间在道路上会车时 -->距离对向来车150米以外 
行车中突遇对方车辆强行超车 占据自己车道 -->尽可能减速避让、直至停车 
在超越前车时 -->提前开启左转向灯 变换使用远、近光灯或者鸣喇叭是为了提醒后车以及前车
车辆在交叉路口有优先通行权的 遇有车辆抢行时 -->应减速避让 必要时停车让行 
在高速公路上行驶 遇低能见度气象条件时 能见度在200米以下 -->车速不得超过每小时60 100 
在高速公路上行驶 遇有雾、雨、雪、沙尘、冰雹等低能见度气象条件下 能见度在100米以下时 -->车速不得超过每小时40 50 
车辆在主干道上行驶 驶近主支干道交汇处时 -->应提前减速、观察 为防止与从支路突然驶入的车辆相撞 谨慎驾驶 
雨天行车 遇撑雨伞和穿雨衣的行人在公路上行走时 -->应提前鸣喇叭 并适当降低车速 
在同向4车道高速公路上行车 -->车速高于每小时110公里的车辆 应在最左侧 
车辆因故障必须在高速公路停车时 -->应在车后方150 
-->距离交叉路口50米以内的路段不能停车。 x
-->在铁路道口、桥梁、陡坡、隧道或者容易发生危险的路段不能掉头。 x
-->社会车辆距离消防栓或者消防队(站)门前30米以内的路段不能停车。 x
驾驶车辆向右变更车道时 -->在确保安全的情况下 注意观察 应提前开启右转向灯 驶入要变更的车道。 
驾驶车辆在道路上行驶时 -->应当按照规定的速度安全行驶。 
-->谨慎驾驶的三原则是集中注意力、仔细观察和提前预防。 x
驾驶车辆变更车道时 保持安全距离 -->注意观察 应提前开启转向灯 驶入要变更的车道。 
车辆转弯时 做到“左转转大弯 -->不要侵占对方的车道 应沿道路右侧行驶 右转转小弯”。 
车辆上坡行驶 -->要提前观察路况、坡道长度 及时减挡使车辆保持充足的动力。 
车辆行至急转弯处时 -->应减速并靠右侧行驶 防止与越过弯道中心线的对方车辆相撞。 
夜间行车 确需超车时 -->要尽量避免超车 可变换远近光灯向前车示意。 
车辆在冰雪路面紧急制动易产生侧滑 -->应低速行驶 可利用发动机制动进行减速。 
夜间行车 遇对面来车未关闭远光灯时 -->应减速行驶 以防两车灯光的交汇处有行人通过时发生事故。 
也 -->雾天行车多使用喇叭可引起对方注意；听到对方车辆鸣喇叭 应鸣喇叭回应。 x
车辆下坡行驶 -->要适当控制车速 充分利用发动机进行制动。 
通过漫水路时 -->要谨慎慢行 不得空挡滑行。 
行车中当车辆前轮爆胎已发生转向时 驾驶人 -->应双手紧握转向盘 尽力控制车辆直线行驶。 
雾天行车听到对方鸣喇叭 也 -->应该鸣喇叭回应 以提示对方车辆。 
车辆后轮胎爆裂 车尾会摇摆不定 驾驶人 控制车辆保持直线行驶 -->应双手紧握转向盘 减速停车。 
机动车、非机动车和行人实行分道行驶 是为了规范交通秩序 -->提高通行效率。 
夜间行车 -->需要超车时 变换远近光灯示意是为了提示前车。 
牵引故障车时 牵引与被牵引的机动车 -->在行驶中都要开启危险报警闪光灯。
车辆进入山区道路后 适时 -->并主动避让车辆及行人 要特别注意“连续转弯”标志 减速和提前鸣喇叭。 
车辆在山区上坡路驾驶 -->减挡要及时、准确、迅速 避免拖挡行驶导致发动机动力不足。 
行经漫水路或者漫水桥时 -->应当停车察明水情。 
机动车在高速公路上发生故障时 将车上人员迅速转移到右侧路肩上或者 -->应急车道内 并且迅速报警。 
机动车在高速公路上遇前方交通受阻时 -->并立即开启危险报警闪光灯 应当跟随前车顺序排队 防止追尾。 
-->车辆在高速公路以每小时100公里的速度行驶时 距同车道前车100米以上为安全距离。 x
在高速公路变更车道时 -->确认安全后 观察情况 应提前开启转向灯 驶入需要变更的车道。 
通过山区危险路段 尤其是通过经常发生塌方、泥石流的山区地段 -->应谨慎驾驶 避免停车。 
超车 -->应该提前开启左转向灯、变换使用远近光灯或鸣喇叭。 
-->注意观察车辆两侧和后方的情况 倒车过程中要缓慢行驶 随时做好停车准备。 x
在道路上超车完毕驶回原车道时 -->开启右转向灯。 
夜间会车时 若对方车辆不关闭远光灯 -->可变换灯光提示对向车辆 同时减速靠右侧行驶或停车。 
车辆下长坡时 -->要减挡行驶 以充分利用发动机的制动作用。 
行车中当驾驶人意识到爆胎时 轻踏制动踏板 使车辆缓慢减速 -->应在控制住方向的情况下 逐渐平稳地停靠于路边。 
驾驶车辆汇入车流时 保持直线行驶 -->通过后视镜观察左右情况 应提前开启转向灯 确认安全后汇入合流。 
车辆发生爆胎后 驾驶人在尚未控制住车速前 -->不要冒险使用行车制动器停车 以避免车辆横甩发生更大的险情。 
-->交通信号包括交通信号灯、交通标志、交通标线和交通警察的指挥。 x
行车中当车辆突然爆胎时 驾驶人切忌慌乱中急踏制动踏板 -->尽量采用“抢挡”的方法 利用发动机制动使车辆减速。 ?
车辆通过铁道路口时 -->中途不得换挡 应用低速挡安全通过 以避免发动机熄火。 
夜间通过没有路灯或路灯照明不良时 -->应将近光灯转换为远光灯 但同向行驶的后车不得使用远光灯。 
超车时 前方车辆不减速让路 -->应停止超车并适当减速 与前方车辆保持安全距离。 
通过学校时 减速慢行 -->要注意观察标志标线 不要鸣喇叭 
-->在山区道路因故障停车需要注意选择平缓路段停放 x
夜间会车时 对面来车不关闭远光灯 及时减速让行 视线向右平移 交替变换远近光灯 -->防止眩目 必要时靠边停车 提醒来车 x
-->在高速公路行车选择服务区停车 x
上坡行驶 -->在车速下降前减挡 
-->在冰雪路面行车注意制动距离延长 x
当机动车在湿滑路面上行驶时 路面附着力随着车速的增加 -->急剧减小 
雾天机动车在道路上通行 保持安全车距 -->驾驶人要减速慢行 正确使用灯光 x
超车时 前方机动车不减速、不让道 驾驶人 -->停止继续超车 
机动车发生侧滑时 向侧滑相反方向转动转向盘 后轮侧滑 -->要前轮侧滑 向侧滑方向转动转向盘 
在冰雪路面上减速或停车 -->要充分利用发动机的牵制作用 
在雾天两车交会时 -->低速大间距 
下长坡时 车速会因为重力作用越来越快 减挡 -->充分利用发动机制动 
驾驶员在高速公路上行驶时 车辆左前轮突然爆胎 须第一时间紧握转向盘 然后轻踏制动踏板进行减速 并将车停靠在紧急停车带上。这样做的原因是爆胎后 车辆行驶方向易发生变化 须紧握转向盘 爆胎后 -->紧急制动容易引起侧翻 x
夜间驾驶汽车驶近上坡路坡顶 合理控制车速 -->交替变换远近光灯
载货汽车牵引挂车时 -->挂车的载质量不得超过载货汽车本身的载质量 
在山区道路上坡路段接近坡顶时 超车存在风险 接近坡顶时视线受阻 接近坡顶时视线受阻 接近坡顶时视线受阻 -->无法观察对向来车情况 无法观察坡顶之后道路走向 无法观察坡顶之后是否有障碍物 x
夜间会车时 对方一直使用远光灯 视线适当右移 避免直视灯光 降低车速 -->靠右行驶 
夜间在窄路遇到对面驶来非机动车时 使用近光灯 -->减速避让 
在山区上坡路段行驶 时 -->应尽量避免换挡 应尽量匀速前进 刻注意下行车辆 
下坡路段车辆由于重力作用 车速容易过快 下坡路段由于重力作用 车辆比平路时 -->在山区道路下坡路段尽量避免超车 操控困难 
突然发生倾翻时 双脚勾住踏板 -->双手紧握转向盘 背部紧靠椅背 
夜间在道路上会车 为避免对方驾驶人眩目 -->应距离对向来车150米以外改用近光灯 
在有让超车条件 保证安全的情况下 -->发现后车开启左转向灯发出超车信号时 减速靠右让路 
关于跟车行驶 -->与前车保持足以采取紧急制动措施的安全距离 
人行横道 -->山区容易塌方、泥石流路段地点不能停车 
在山区路段超车时 提前鸣喇叭 -->提前开启左转向灯 确认前车让超后超越 
关于汇入主路车流 -->不得妨碍主路车辆正常行驶 
夜间会车时 -->应当使用近光灯 如遇对方持续开启远光灯 低速会车或停车让行 
在山区道路上坡路段行驶 因发生故障需停车检修时 拉起驻车制动器 在后方用塞车木或石块塞住车轮 以防车辆后溜 -->开启危险报警闪光灯 按规定在车后方设置警示标志 
驾驶汽车在山区道路转弯下陡坡路段遇对面来车 转弯前减速 -->靠路右侧行驶 
大雾天在高速公路遇事故不能继续行驶时 -->车上人员站到护栏以外安全的地方 
关于超车 超车时 从前车左侧超越 超车完毕 -->与被超车拉开必要的安全距离后开启右转向灯驶回原车道 
在山区道路行驶时 上坡路段的安全距离 -->应比平坦路段的大 
机动车在行驶中突遇制动失灵时 抢挂低速挡减速 使用驻车制动器减速 -->驾驶人要采取握稳方向 开启危险报警闪光灯措施 
在泥泞路段行车 -->要用加速踏板 
有效预防机动车发生制动失效的措施是定期维护制动系统 行车前检查制动踏板的自由行程 正确使用制动 采用液压制动的机动车 -->防止热衰退 行车前检查制动液是否有滴漏 
预防公交车突然起步 预防行人从车前穿出 -->驾驶汽车驶近停有公交车的车站需要注意做好随时停车的准备 与公交车保持安全间距 
下坡路行驶 制动突然失效后 用车身靠向路旁的岩石或树木碰擦 -->可采用的减速方法是利用道路边专设避险车道减速停车 抢挂低速档 
驶入高速公路减速车道后 -->注意观察限速标志 应关闭转向灯 进入匝道之前将车速降到标志规定车速以下 
在山区道路行驶时 上坡路段的安全距离 -->应比平坦路段的大 
驾驶汽车在道路急转弯处 减速靠路右侧行驶 不能占用方车道 注意对面来车 -->鸣喇叭示意 
转向失控后 若机动车偏离直线行驶方向 -->应果断地连续踩踏、放松制动踏板 
机动车在高速公路上行驶 遇有雾、雨、雪且能见度在100米至200米之间时 车速不超过60km/h -->应该开启雾灯、近光灯、示廓灯、前后位灯 与同车道前车保持100米以上的距离 
机动车在高速行驶中 保持直行 立即松开加速踏板 -->突然爆胎要牢牢地握住转向盘 轻踩制动踏板 
遇紧急情况避险时 -->要沉着冷静 坚持先避人后避物样的处理原则 
机动车上高速公路 -->不准倒车、逆行、穿越中央分隔带掉头 
机动车在夜间发生故障时 -->开启示廓灯和后位灯 开启危险报警闪光灯 驾驶人要做选择安全区域停车 按规定设置警告标志以确保安全 
机动车因故障必须在高速公路上停车时 -->夜间要开启示廓灯和后位灯 要在车后150米处设置故障警告标志 要开启危险报警闪光灯 
-->在雨天临时停车注意开启危险报警闪光灯 x
驾驶汽车从支线道路 -->仔细观察主干道内情况 提前开启左转向灯 确认安全后汇入车流 
机动车因故障或者事故在高速公路行车道上紧急停车时 驾乘人员 迅速转移至右侧路肩上或 -->应急车道内 x
行车中发动机突然熄火后 -->将机动车移到不妨碍交通的地点停车 要采取立即开启危险报警闪光灯 放置故障车警告标志措施 
通过居民小区时 低速行驶 不鸣喇叭 -->需要注意遵守标志 避让居民 x
遇有漫水路时 低速通过 机动车涉水后 -->确认安全后 要停车察明水情 间断轻踏制动踏板 
与对向来车发生正面碰撞且碰撞位置在驾驶人正前方时 驾驶人迅速躲离转向盘 往副驾驶座位躲避 -->迅速将两腿抬起 
遇暴雨 无法看清路面情况 -->打开危险报警闪光灯 将机动车停到路外 
在普通道路驾车遇暴雨 刮水器无法改善驾驶人视线 此时 -->要立即减速靠边停驶 
掉头时 -->提前开启左转向灯 在掉头车道掉头 
关于超车 提醒前方被超车辆驾驶人 切换远、近光灯提醒前方被超车辆驾驶人 -->超车前提前开启左转向灯 完成超车后并回行车道要开启右转向灯 
大风天气行车 由于风速和风向不断地发生变化 当感到转向盘突然难以控制时 -->驾驶人要双手稳握转向盘 
车辆发生“水滑”时 逐渐松抬加速踏板 让车速逐渐减缓 -->不可急踩制动踏板 不得迅速转向 x
关于超车 超车时 从前车左侧超越 超车完毕 -->与被超车拉开必要的安全距离后开启右转向灯驶回原车道 x
通过学校门口时 注意减速慢行 -->应注意注意观察标志标线 不要鸣喇叭 x
人行横道 -->山区容易塌方、泥石流路段地点不能停车 
-->出车前对轮胎进行轮胎的紧固和气压的检查 
遇到校车在道路右侧停车上下学生 同向有两条机动车道时 左侧车道后方机动车 -->应当停车等待。 
机动车涉水后 -->驾驶人要间断轻踩制动踏板 以恢复制动效能。 
-->涉水驾驶要保持车速均匀有足够动力 避免停留。 x
扑救易散发腐蚀性蒸气或有毒气体的火灾时 扑救人员 -->应穿戴防毒面具和相应的防护用品 站在上风处施救。 
机动车在高速公路意外撞击护栏时 适当修正 -->要稳住方向 切忌猛转转向盘。 
-->在雾天行车要开启雾灯。 x
-->也要鸣喇叭回 雾天公路行车可多使用喇叭引起对向注意；听到对向机动车鸣喇叭 应。 x
雨天在高速公路行车 为避免发生“水滑”现象而造成方向失控 -->要降低车速。 
-->在高速公路上行驶不得倒车、逆行、穿越中央分隔带掉头或者在车道内停车。 x
通过积水路段时 降低车速 -->应注意两侧的行人和非机动车 防止路面积水飞溅。 
在上坡道路跟车行驶 遇到前车停车时 -->为防止前车起步时溜车 应适当加大安全距离。 
遇到道路交通事故 过往车辆驾驶人 -->应当予以协助。 
驶入高速公路收费口 有序行驶 -->应减速慢行 选择绿灯亮起的收费口进入。 
同方向有三条机动车道的路段 校车在右侧车道停靠上、下学生时 校车停靠车道后方和相邻机动车道上的机动车 -->应停车等待。 
汇入车流时 -->认真观察主路上车辆的行驶情况 应当开启转向灯 在不妨碍主路车辆正常行驶的前提下汇入车流。 
在交通事故现场 一旦遇到有毒有害物质泄漏 -->一定要第一时间疏散人员 并立即报警。 
行车前 -->应对机动车驾驶室、发动机舱、车外部、轮胎进行检查。 
会车时 双方都 -->应做到减速靠右通过 当视线受阻不利于观察到对向来车时 并鸣喇叭示意。
在高速公路行驶遇到横风时 -->应紧握方向盘 减速行驶。 
驾驶客车遇非常情况或者发生事故时 -->要力所能及的将损失降到最低限度 决不能因紧急避险造成二次事故或更大的损失。
前方遇有大型拉土（石）货车 -->应当尽量远离 避让。 
下坡路制动失效后 -->要迅速逐级或越一级减挡 利用发动机制动作用控制车速。 
在高速公路行驶 由加速车道汇入行车道时 操纵方向盘不 -->应该过急过猛。 x
在冰雪道路上行车时 机动车的稳定性降低 -->加速过急时车轮易空转或溜滑。 
机动车行经交叉路口 -->不得超车。 
-->在雨天湿滑路面行车要尽量避免紧急制动。 x
行车中当机动车突然爆胎时 驾驶人切忌慌乱中急踏制动踏板 -->尽量采用抢挂低速档的方法 利用发动机制动使机动车减速。 
机动车在高速行驶时 前面扬起的飞石或是遗撒物将挡风玻璃击裂 造成视线模糊不清的状况下 -->驾驶人要逐渐降低车速、开启危险报警闪光灯并将机动车移至不妨碍交通的地点。 
下坡路制动失效后 驾驶人 拉紧驻车制动器 -->应立即寻找并冲入紧急避险车道；停车后 以防溜动发生二次险情。 
行车中当突然爆胎时 -->驾驶人要双手紧握转向盘 尽力控制机动车直线行驶。 
遇到校车在道路右侧停车上下学生 同向只有一条机动车道时 后方机动车 -->应当停车等待。 x
驾驶汽车在非禁鸣路段 遇复杂交通情况时 -->可合理使用喇叭。 
下坡路制动失效后 -->应迅速逐级或越一级减挡 若无可利用的地形和时机 利用发动机制动作用控制车速。 
当机动车已偏离直线行驶方向 -->尽量缩短停车距离 应果断地连续踏制动踏板 事故已经无可避免时 减轻撞车力度。 
驾驶人行车中意识到爆胎时 -->要轻踏制动踏板 缓慢减速停车。 
-->驾驶人下车前要观察后视镜和侧头观察左后侧情况。 x
机动车行经视线受阻的急弯路段时 如遇对方车辆鸣喇叭示意 也 -->应当及时鸣喇叭进行回应。 
当感觉与对向驶来的车辆会有会车困难的时候 -->应及时减速靠边行驶 或停车让行。 
发生交通事故后 -->应注意是否有燃油泄漏、管路破裂的情况 避免意外情况出现。 
雪天行车 由于路面湿滑 车轮附着力减小 因此 -->应当加大两车之间的安全距离。 
多车跟车行驶 为避免追尾事故发生 -->应至少观察前方两到三辆车 从而能对减速或停车具有预见性。 
在山区道路会车时 -->应该尽量提前让行 为临崖车辆留出足够的时间、空间会车。 


错误：32